{
    "Rows" : 12,
    "Cols" : 10,
    "Background_data" : 
	[0, 1, 1, 2, 1, 3, 3, 3, 0, 0,
	 0, 1, 1, 2, 1, 3, 3, 3, 0, 0,
	 0, 1, 1, 2, 1, 3, 3, 3, 0, 0,
	 0, 1, 1, 2, 1, 3, 3, 3, 0, 0,
	 0, 1, 1, 2, 1, 3, 3, 3, 0, 0,
	 0, 1, 1, 2, 1, 3, 3, 3, 0, 0,
	 0, 1, 1, 2, 1, 3, 3, 3, 0, 0,
	 0, 1, 1, 2, 1, 3, 3, 3, 0, 0,
	 0, 1, 1, 2, 1, 3, 3, 3, 0, 0,
	 0, 1, 1, 2, 1, 3, 3, 3, 0, 0,
	 0, 1, 1, 2, 1, 3, 3, 3, 0, 0,
	 0, 1, 1, 2, 1, 3, 3, 3, 0, 0],
	 
    "Surface_data" : 
	[0, 1, 1, 2, 1, 3, 3, 3, 0, 0,
	 0, 0, 0, 0, 0, 0, 0, 0, 0, 0,
	 0, 0, 0, 0, 0, 0, 0, 0, 0, 0,
	 0, 0, 0, 0, 0, 0, 0, 0, 0, 0,
	 0, 0, 0, 0, 0, 0, 0, 0, 0, 0,
	 0, 0, 0, 0, 0, 0, 0, 0, 0, 0,
	 0, 0, 0, 0, 0, 0, 0, 0, 0, 0,
	 0, 0, 0, 0, 0, 0, 0, 0, 0, 0,
	 0, 0, 0, 0, 0, 0, 0, 0, 0, 0,
	 0, 0, 0, 0, 0, 0, 0, 0, 0, 0,
	 0, 0, 0, 0, 0, 0, 0, 0, 0, 0,
	 0, 1, 1, 2, 1, 3, 3, 3, 0, 0]
}