{
	"TileSet" : "Maps/tiles.json",
    "Rows" : 12,
    "Cols" : 10,
    "Background_data" : 
	[1, 1, 1, 1, 1, 1, 1, 1, 1, 1,
	 4, 4, 4, 4, 4, 4, 4, 4, 4, 4,
	 4, 4, 4, 4, 4, 4, 4, 4, 4, 4,
	 4, 4, 4, 4, 4, 4, 4, 4, 4, 4,
	 4, 5, 4, 5, 4, 4, 4, 4, 4, 4,
	 4, 4, 4, 4, 4, 4, 4, 4, 4, 4,
	 4, 4, 4, 4, 4, 4, 4, 4, 4, 4,
	 4, 4, 4, 4, 4, 4, 4, 4, 4, 4,
	 4, 4, 4, 4, 4, 4, 4, 4, 3, 3,
	 5, 4, 4, 4, 4, 4, 4, 3, 3, 3,
	 6, 5, 4, 4, 4, 4, 4, 3, 3, 3,
	 6, 6, 4, 4, 4, 4, 4, 3, 3, 3],
	 
    "Resource_data" : 
	[0, 0, 1, 0, 0, 0, 0, 0, 1, 0,
	 0, 0, 0, 0, 0, 0, 0, 0, 0, 0,
	 0, 0, 0, 0, 0, 0, 0, 0, 0, 0,
	 0, 0, 0, 0, 0, 0, 0, 0, 0, 0,
	 0, 0, 0, 0, 0, 0, 0, 0, 0, 0,
	 0, 0, 0, 0, 0, 0, 0, 0, 0, 0,
	 0, 0, 0, 0, 0, 0, 0, 0, 0, 0,
	 0, 0, 0, 0, 0, 0, 0, 0, 0, 0,
	 0, 0, 0, 0, 0, 0, 0, 0, 0, 0,
	 0, 0, 0, 0, 0, 0, 0, 0, 0, 0,
	 0, 0, 0, 0, 0, 0, 0, 0, 0, 0,
	  0, 0, 0, 0, 0, 0, 0, 0, 0, 0]
}